###########x###################
#.............................#
#........  ...................#
#................   ..........#
#.............................x
#...... ......................#
#  .............    ..........#
#................ .  .........#
######....   .................#
#. ..#..............    ......#
x@..................   ...  ..#
#..#.......... ...............#
######........................#
#......   .....K..............#
###############################