##############x################
#.............................#
#........  ...................#
#................   ..........#
#.............................#
#...... ......................#
#  .............    ..........#
#................ .  .........#
######....   .................#
#. ..#..............    ......#
#@..................   ...  ..#
#..#.......... ...............#
######........................#
#......   .....K..............#
####Q##########################