############X#######
#..................#
#..................#
#..................#
#..................X
#..................#
x@.................#
#..................#
#..................#
#..................#
#..................#
#..................#
#..................#
#................K.#
####X###############