#################################
#...............................#
#........  .....................#
#................     ..........#
#...............................x
#...... ........................#
#  ...............    ..........#
#.................. .  .........#
######....     .................#
#. ..#................    ......#
x@....................   ...  ..#
#....#.......... ...............#
######..........................#
#........   .....K..............#
####X############################