#########X#####################
#.......#..  #................#
#.....###... #................#
#.....#....###................#
#.....#... #..................x
#....##  ###..................#
#..................  .........#
#...K...........   ...........#
#. ###.......... .............#
#.........  .... .............#
x@.........      .............#
#.............................#
#.............................#
#.............................#
###############################